NO ./assets/north_texture
SO ./assets/south_texture
WE ./assets/west_texture
EA ./assets/east_texture

F 220,100,0
C 225,30,0

111111111111111111111111111111111
110000000001100000000000011111111
110110000011100000000000011111111
110010000000000000000000011111111
111111111101100000111000011111111
11000000E001100000111011111111111
111111111111111111111111111111111
