NO    ./assets/wall_1.xpm

SO ./assets/Texture_128x128_10-0.xpm

WE ./assets/Texture_128x128_10-14.xpm

EA ./assets/Texture_128x128_10-17.xpm

F 220,100,0

C 225,30,0


11111111111111111
10110000000000001
1111000000N000001
10000000000000001
11111111111111111
11111111111111111
11111111
1111111111111
100000001 1111111
111111111