NO ./assets/north_texture.xpm
SO ./assets/south_texture.xpm
WE ./assets/west_texture.xpm
EA ./assets/east_texture.xpm

F 220,100,0
C 225,30,0

 11111111111111111111111111111111
 1000000000110000000000001
 1011000001110000000000001   111
 100100000000000100000000011111111
 111111111011000001110000000000001    1111
 100000000011000001110111111111111     101
 11110111111111011100000010001          11
 11110111111111011101010010001
 11000000110101011100000010001
 10000000000000001100000010001
 10000000000000001101010010001
 11000001110101011111011110N0111
 1111011111101011011110100011
 11111111 11111111 111111111
