NO    ./assets/wall_1.xpm

SO ./assets/Texture_128x128_10-0.xpm

WE ./assets/Texture_128x128_10-14.xpm

EA ./assets/Texture_128x128_10-17.xpm

F 220,100,0

C 225,30,0



1111111111111111111111111
1000000000110000000000001
101100000111000000N000001
1001000000000000000000001
11111111111111111111111111111111
111111111011000001110000100000001
100000000011000001110111111111111
11110111111111011100000010001
11110111111111011101010010001
11000000110101011100000010001
10000000000000001100000010001
10000000000000001101010010001
110000011101010111110111100111
1111011111110101101111010001
1111111111111111111111111111
