N

EA

















F 220,100,0                       
C 225,30,0

1111111111111111111111111111111111111111111111111111111
1000000000000000N00000000000N00000000000000000000000001
1111111111111111111111111111111111111111111111111111111